Feature ID	Taxon
Novosphingobium resinovorum	k__ ; p__Pseudomonadota; c__Alphaproteobacteria; o__Sphingomonadales; f__Sphingomonadaceae; g__Novosphingobium; s__Novosphingobium resinovorum
Novosphingobium sp. EMRT-2	k__ ; p__Pseudomonadota; c__Alphaproteobacteria; o__Sphingomonadales; f__Sphingomonadaceae; g__Novosphingobium; s__Novosphingobium sp. EMRT-2
Novosphingobium sp. P6W	k__ ; p__Pseudomonadota; c__Alphaproteobacteria; o__Sphingomonadales; f__Sphingomonadaceae; g__Novosphingobium; s__Novosphingobium sp. P6W
Novosphingobium pentaromativorans	k__ ; p__Pseudomonadota; c__Alphaproteobacteria; o__Sphingomonadales; f__Sphingomonadaceae; g__Novosphingobium; s__Novosphingobium pentaromativorans
Novosphingobium decolorationis	k__ ; p__Pseudomonadota; c__Alphaproteobacteria; o__Sphingomonadales; f__Sphingomonadaceae; g__Novosphingobium; s__Novosphingobium decolorationis
Sphingopyxis sp. 113P3	k__ ; p__Pseudomonadota; c__Alphaproteobacteria; o__Sphingomonadales; f__Sphingomonadaceae; g__Sphingopyxis; s__Sphingopyxis sp. 113P3
Sphingopyxis sp. FD7	k__ ; p__Pseudomonadota; c__Alphaproteobacteria; o__Sphingomonadales; f__Sphingomonadaceae; g__Sphingopyxis; s__Sphingopyxis sp. FD7
Sphingopyxis alaskensis	k__ ; p__Pseudomonadota; c__Alphaproteobacteria; o__Sphingomonadales; f__Sphingomonadaceae; g__Sphingopyxis; s__Sphingopyxis alaskensis
Sphingopyxis macrogoltabida	k__ ; p__Pseudomonadota; c__Alphaproteobacteria; o__Sphingomonadales; f__Sphingomonadaceae; g__Sphingopyxis; s__Sphingopyxis macrogoltabida
Sphingopyxis fribergensis	k__ ; p__Pseudomonadota; c__Alphaproteobacteria; o__Sphingomonadales; f__Sphingomonadaceae; g__Sphingopyxis; s__Sphingopyxis fribergensis
Sphingopyxis lindanitolerans	k__ ; p__Pseudomonadota; c__Alphaproteobacteria; o__Sphingomonadales; f__Sphingomonadaceae; g__Sphingopyxis; s__Sphingopyxis lindanitolerans
Sphingobium sp. Cam5-1	k__ ; p__Pseudomonadota; c__Alphaproteobacteria; o__Sphingomonadales; f__Sphingomonadaceae; g__Sphingobium; s__Sphingobium sp. Cam5-1
Sphingobium sp. CAP-1	k__ ; p__Pseudomonadota; c__Alphaproteobacteria; o__Sphingomonadales; f__Sphingomonadaceae; g__Sphingobium; s__Sphingobium sp. CAP-1
Sphingobium sp. RAC03	k__ ; p__Pseudomonadota; c__Alphaproteobacteria; o__Sphingomonadales; f__Sphingomonadaceae; g__Sphingobium; s__Sphingobium sp. RAC03
Sphingobium sp. TKS	k__ ; p__Pseudomonadota; c__Alphaproteobacteria; o__Sphingomonadales; f__Sphingomonadaceae; g__Sphingobium; s__Sphingobium sp. TKS
Sphingobium sp. EP60837	k__ ; p__Pseudomonadota; c__Alphaproteobacteria; o__Sphingomonadales; f__Sphingomonadaceae; g__Sphingobium; s__Sphingobium sp. EP60837
Sphingobium baderi	k__ ; p__Pseudomonadota; c__Alphaproteobacteria; o__Sphingomonadales; f__Sphingomonadaceae; g__Sphingobium; s__Sphingobium baderi
Sphingobium cloacae	k__ ; p__Pseudomonadota; c__Alphaproteobacteria; o__Sphingomonadales; f__Sphingomonadaceae; g__Sphingobium; s__Sphingobium cloacae
Sphingobium herbicidovorans	k__ ; p__Pseudomonadota; c__Alphaproteobacteria; o__Sphingomonadales; f__Sphingomonadaceae; g__Sphingobium; s__Sphingobium herbicidovorans
Sphingobium amiense	k__ ; p__Pseudomonadota; c__Alphaproteobacteria; o__Sphingomonadales; f__Sphingomonadaceae; g__Sphingobium; s__Sphingobium amiense
Sphingobium indicum	k__ ; p__Pseudomonadota; c__Alphaproteobacteria; o__Sphingomonadales; f__Sphingomonadaceae; g__Sphingobium; s__Sphingobium indicum
Sphingomonas sp. IC081	k__ ; p__Pseudomonadota; c__Alphaproteobacteria; o__Sphingomonadales; f__Sphingomonadaceae; g__Sphingomonas; s__Sphingomonas sp. IC081
Sphingomonas sp. NBWT7	k__ ; p__Pseudomonadota; c__Alphaproteobacteria; o__Sphingomonadales; f__Sphingomonadaceae; g__Sphingomonas; s__Sphingomonas sp. NBWT7
Sphingomonas sp. FARSPH	k__ ; p__Pseudomonadota; c__Alphaproteobacteria; o__Sphingomonadales; f__Sphingomonadaceae; g__Sphingomonas; s__Sphingomonas sp. FARSPH
Sphingomonas sanxanigenens	k__ ; p__Pseudomonadota; c__Alphaproteobacteria; o__Sphingomonadales; f__Sphingomonadaceae; g__Sphingomonas; s__Sphingomonas sanxanigenens
Rhizorhabdus dicambivorans	k__ ; p__Pseudomonadota; c__Alphaproteobacteria; o__Sphingomonadales; f__Sphingomonadaceae; g__Rhizorhabdus; s__Rhizorhabdus dicambivorans
Tardibacter chloracetimidivorans	k__ ; p__Pseudomonadota; c__Alphaproteobacteria; o__Sphingomonadales; f__Sphingomonadaceae; g__Tardibacter; s__Tardibacter chloracetimidivorans
Croceicoccus marinus	k__ ; p__Pseudomonadota; c__Alphaproteobacteria; o__Sphingomonadales; f__Erythrobacteraceae; g__Croceicoccus; s__Croceicoccus marinus
Croceicoccus naphthovorans	k__ ; p__Pseudomonadota; c__Alphaproteobacteria; o__Sphingomonadales; f__Erythrobacteraceae; g__Croceicoccus; s__Croceicoccus naphthovorans
Porphyrobacter sp. YT40	k__ ; p__Pseudomonadota; c__Alphaproteobacteria; o__Sphingomonadales; f__Erythrobacteraceae; g__Porphyrobacter; s__Porphyrobacter sp. YT40
Aurantiacibacter atlanticus	k__ ; p__Pseudomonadota; c__Alphaproteobacteria; o__Sphingomonadales; f__Erythrobacteraceae; g__Aurantiacibacter; s__Aurantiacibacter atlanticus
Salipiger profundus	k__ ; p__Pseudomonadota; c__Alphaproteobacteria; o__Rhodobacterales; f__Roseobacteraceae; g__Salipiger; s__Salipiger profundus
Salipiger abyssi	k__ ; p__Pseudomonadota; c__Alphaproteobacteria; o__Rhodobacterales; f__Roseobacteraceae; g__Salipiger; s__Salipiger abyssi
Salipiger sp. CCB-MM3	k__ ; p__Pseudomonadota; c__Alphaproteobacteria; o__Rhodobacterales; f__Roseobacteraceae; g__Salipiger; s__Salipiger sp. CCB-MM3
Sulfitobacter sp. D7	k__ ; p__Pseudomonadota; c__Alphaproteobacteria; o__Rhodobacterales; f__Roseobacteraceae; g__Sulfitobacter; s__Sulfitobacter sp. D7
Sulfitobacter sp. THAF37	k__ ; p__Pseudomonadota; c__Alphaproteobacteria; o__Rhodobacterales; f__Roseobacteraceae; g__Sulfitobacter; s__Sulfitobacter sp. THAF37
Sulfitobacter alexandrii	k__ ; p__Pseudomonadota; c__Alphaproteobacteria; o__Rhodobacterales; f__Roseobacteraceae; g__Sulfitobacter; s__Sulfitobacter alexandrii
Sagittula sp. P11	k__ ; p__Pseudomonadota; c__Alphaproteobacteria; o__Rhodobacterales; f__Roseobacteraceae; g__Sagittula; s__Sagittula sp. P11
Roseovarius mucosus	k__ ; p__Pseudomonadota; c__Alphaproteobacteria; o__Rhodobacterales; f__Roseobacteraceae; g__Roseovarius; s__Roseovarius mucosus
Roseovarius indicus	k__ ; p__Pseudomonadota; c__Alphaproteobacteria; o__Rhodobacterales; f__Roseobacteraceae; g__Roseovarius; s__Roseovarius indicus
Roseovarius sp. THAF9	k__ ; p__Pseudomonadota; c__Alphaproteobacteria; o__Rhodobacterales; f__Roseobacteraceae; g__Roseovarius; s__Roseovarius sp. THAF9
Ruegeria sp. THAF33	k__ ; p__Pseudomonadota; c__Alphaproteobacteria; o__Rhodobacterales; f__Roseobacteraceae; g__Ruegeria; s__Ruegeria sp. THAF33
Ruegeria sp. TM1040	k__ ; p__Pseudomonadota; c__Alphaproteobacteria; o__Rhodobacterales; f__Roseobacteraceae; g__Ruegeria; s__Ruegeria sp. TM1040
Celeribacter indicus	k__ ; p__Pseudomonadota; c__Alphaproteobacteria; o__Rhodobacterales; f__Roseobacteraceae; g__Celeribacter; s__Celeribacter indicus
Octadecabacter sp. SW4	k__ ; p__Pseudomonadota; c__Alphaproteobacteria; o__Rhodobacterales; f__Roseobacteraceae; g__Octadecabacter; s__Octadecabacter sp. SW4
Yangia pacifica	k__ ; p__Pseudomonadota; c__Alphaproteobacteria; o__Rhodobacterales; f__Roseobacteraceae; g__Alloyangia; s__Alloyangia pacifica
Pseudosulfitobacter pseudonitzschiae	k__ ; p__Pseudomonadota; c__Alphaproteobacteria; o__Rhodobacterales; f__Roseobacteraceae; g__Pseudosulfitobacter; s__Pseudosulfitobacter pseudonitzschiae
Phaeobacter porticola	k__ ; p__Pseudomonadota; c__Alphaproteobacteria; o__Rhodobacterales; f__Roseobacteraceae; g__Phaeobacter; s__Phaeobacter porticola
Pacificitalea manganoxidans	k__ ; p__Pseudomonadota; c__Alphaproteobacteria; o__Rhodobacterales; f__Paracoccaceae; g__Pacificitalea; s__Pacificitalea manganoxidans
Paracoccus tegillarcae	k__ ; p__Pseudomonadota; c__Alphaproteobacteria; o__Rhodobacterales; f__Paracoccaceae; g__Paracoccus; s__Paracoccus tegillarcae
Paracoccus zhejiangensis	k__ ; p__Pseudomonadota; c__Alphaproteobacteria; o__Rhodobacterales; f__Paracoccaceae; g__Paracoccus; s__Paracoccus zhejiangensis
Gemmobacter fulva	k__ ; p__Pseudomonadota; c__Alphaproteobacteria; o__Rhodobacterales; f__Paracoccaceae; g__Gemmobacter; s__Gemmobacter fulvus
Paracoccaceae bacterium	k__ ; p__Pseudomonadota; c__Alphaproteobacteria; o__Rhodobacterales; f__Paracoccaceae; g__ ; s__Paracoccaceae bacterium
Pseudohalocynthiibacter aestuariivivens	k__ ; p__Pseudomonadota; c__Alphaproteobacteria; o__Rhodobacterales; f__Paracoccaceae; g__Pseudohalocynthiibacter; s__Pseudohalocynthiibacter aestuariivivens
Pukyongiella litopenaei	k__ ; p__Pseudomonadota; c__Alphaproteobacteria; o__Rhodobacterales; f__Paracoccaceae; g__Pukyongiella; s__Pukyongiella litopenaei
Rhodovulum sp. P5	k__ ; p__Pseudomonadota; c__Alphaproteobacteria; o__Rhodobacterales; f__Paracoccaceae; g__Rhodovulum; s__Rhodovulum sp. P5
Martelella mediterranea	k__ ; p__Pseudomonadota; c__Alphaproteobacteria; o__Hyphomicrobiales; f__Aurantimonadaceae; g__Martelella; s__Martelella mediterranea
Martelella sp. AD-3	k__ ; p__Pseudomonadota; c__Alphaproteobacteria; o__Hyphomicrobiales; f__Aurantimonadaceae; g__Martelella; s__Martelella sp. AD-3
Martelella sp. NC20	k__ ; p__Pseudomonadota; c__Alphaproteobacteria; o__Hyphomicrobiales; f__Aurantimonadaceae; g__Martelella; s__Martelella sp. NC20
Rhizobium oryzihabitans	k__ ; p__Pseudomonadota; c__Alphaproteobacteria; o__Hyphomicrobiales; f__Rhizobiaceae; g__Rhizobium; s__Rhizobium oryzihabitans
Pseudorhizobium flavum	k__ ; p__Pseudomonadota; c__Alphaproteobacteria; o__Hyphomicrobiales; f__Rhizobiaceae; g__Pseudorhizobium; s__Pseudorhizobium flavum
Agrobacterium tumefaciens	k__ ; p__Pseudomonadota; c__Alphaproteobacteria; o__Hyphomicrobiales; f__Rhizobiaceae; g__Agrobacterium; s__Agrobacterium tumefaciens
Shinella sp. PSBB067	k__ ; p__Pseudomonadota; c__Alphaproteobacteria; o__Hyphomicrobiales; f__Rhizobiaceae; g__Shinella; s__Shinella sp. PSBB067
Beijerinckiaceae bacterium RH AL1	k__ ; p__Pseudomonadota; c__Alphaproteobacteria; o__Hyphomicrobiales; f__Beijerinckiaceae; g__ ; s__Beijerinckiaceae bacterium RH AL1
Roseibium aggregatum	k__ ; p__Pseudomonadota; c__Alphaproteobacteria; o__Hyphomicrobiales; f__Stappiaceae; g__Roseibium; s__Roseibium aggregatum
Methylobacterium brachiatum	k__ ; p__Pseudomonadota; c__Alphaproteobacteria; o__Hyphomicrobiales; f__Methylobacteriaceae; g__Methylobacterium; s__Methylobacterium brachiatum
Methylorubrum populi	k__ ; p__Pseudomonadota; c__Alphaproteobacteria; o__Hyphomicrobiales; f__Methylobacteriaceae; g__Methylorubrum; s__Methylorubrum populi
Brucella anthropi	k__ ; p__Pseudomonadota; c__Alphaproteobacteria; o__Hyphomicrobiales; f__Brucellaceae; g__Brucella; s__Brucella anthropi
Tistrella mobilis	k__ ; p__Pseudomonadota; c__Alphaproteobacteria; o__Geminicoccales; f__Geminicoccaceae; g__Tistrella; s__Tistrella mobilis
Indioceanicola profundi	k__ ; p__Pseudomonadota; c__Alphaproteobacteria; o__Rhodospirillales; f__Azospirillaceae; g__Indioceanicola; s__Indioceanicola profundi
Salinimonas iocasae	k__ ; p__Pseudomonadota; c__Gammaproteobacteria; o__Alteromonadales; f__Alteromonadaceae; g__Salinimonas; s__Salinimonas iocasae
Alteromonas sp. RKMC-009	k__ ; p__Pseudomonadota; c__Gammaproteobacteria; o__Alteromonadales; f__Alteromonadaceae; g__Alteromonas; s__Alteromonas sp. RKMC-009
Pseudoalteromonas arctica	k__ ; p__Pseudomonadota; c__Gammaproteobacteria; o__Alteromonadales; f__Pseudoalteromonadaceae; g__Pseudoalteromonas; s__Pseudoalteromonas arctica
Pseudoalteromonas shioyasakiensis	k__ ; p__Pseudomonadota; c__Gammaproteobacteria; o__Alteromonadales; f__Pseudoalteromonadaceae; g__Pseudoalteromonas; s__Pseudoalteromonas shioyasakiensis
Pseudoalteromonas sp. NC201	k__ ; p__Pseudomonadota; c__Gammaproteobacteria; o__Alteromonadales; f__Pseudoalteromonadaceae; g__Pseudoalteromonas; s__Pseudoalteromonas sp. NC201
Shewanella aestuarii	k__ ; p__Pseudomonadota; c__Gammaproteobacteria; o__Alteromonadales; f__Shewanellaceae; g__Shewanella; s__Shewanella aestuarii
Shewanella sp. ANA-3	k__ ; p__Pseudomonadota; c__Gammaproteobacteria; o__Alteromonadales; f__Shewanellaceae; g__Shewanella; s__Shewanella sp. ANA-3
Halomonas ventosae	k__ ; p__Pseudomonadota; c__Gammaproteobacteria; o__Oceanospirillales; f__Halomonadaceae; g__Halomonas; s__Halomonas ventosae
Halomonas sulfidaeris	k__ ; p__Pseudomonadota; c__Gammaproteobacteria; o__Oceanospirillales; f__Halomonadaceae; g__Vreelandella; s__Vreelandella sulfidaeris
Proteus sp. ZN5	k__ ; p__Pseudomonadota; c__Gammaproteobacteria; o__Enterobacterales; f__Morganellaceae; g__Proteus; s__Proteus sp. ZN5
Enterobacter cloacae complex sp. ECNIH7	k__ ; p__Pseudomonadota; c__Gammaproteobacteria; o__Enterobacterales; f__Enterobacteriaceae; g__Enterobacter; s__Enterobacter cloacae complex sp. ECNIH7
Raoultella electrica	k__ ; p__Pseudomonadota; c__Gammaproteobacteria; o__Enterobacterales; f__Enterobacteriaceae; g__Klebsiella; s__Klebsiella electrica
Vibrio tubiashii	k__ ; p__Pseudomonadota; c__Gammaproteobacteria; o__Vibrionales; f__Vibrionaceae; g__Vibrio; s__Vibrio tubiashii
Vibrio rumoiensis	k__ ; p__Pseudomonadota; c__Gammaproteobacteria; o__Vibrionales; f__Vibrionaceae; g__Vibrio; s__Vibrio rumoiensis
Marinobacter sp. NP-4(2019)	k__ ; p__Pseudomonadota; c__Gammaproteobacteria; o__Pseudomonadales; f__Marinobacteraceae; g__Marinobacter; s__Marinobacter sp. NP-4(2019)
Marinobacter sp. JH2	k__ ; p__Pseudomonadota; c__Gammaproteobacteria; o__Pseudomonadales; f__Marinobacteraceae; g__Marinobacter; s__Marinobacter sp. JH2
Pseudomonas putida	k__ ; p__Pseudomonadota; c__Gammaproteobacteria; o__Pseudomonadales; f__Pseudomonadaceae; g__Pseudomonas; s__Pseudomonas putida
Pseudomonas resinovorans	k__ ; p__Pseudomonadota; c__Gammaproteobacteria; o__Pseudomonadales; f__Pseudomonadaceae; g__Metapseudomonas; s__Metapseudomonas resinovorans
Stutzerimonas stutzeri	k__ ; p__Pseudomonadota; c__Gammaproteobacteria; o__Pseudomonadales; f__Pseudomonadaceae; g__Stutzerimonas; s__Stutzerimonas stutzeri
Acinetobacter piscicola	k__ ; p__Pseudomonadota; c__Gammaproteobacteria; o__Moraxellales; f__Moraxellaceae; g__Acinetobacter; s__Acinetobacter piscicola
Moraxella osloensis	k__ ; p__Pseudomonadota; c__Gammaproteobacteria; o__Moraxellales; f__Moraxellaceae; g__Faucicola; s__Faucicola osloensis
Microbacterium paraoxydans	k__ ; p__Actinomycetota; c__Actinomycetes; o__Micrococcales; f__Microbacteriaceae; g__Microbacterium; s__Microbacterium paraoxydans
Microbacterium sediminis	k__ ; p__Actinomycetota; c__Actinomycetes; o__Micrococcales; f__Microbacteriaceae; g__Microbacterium; s__Microbacterium sediminis
Microbacterium sp. No. 7	k__ ; p__Actinomycetota; c__Actinomycetes; o__Micrococcales; f__Microbacteriaceae; g__Microbacterium; s__Microbacterium sp. No. 7
Microbacterium sp. NIBRBAC000506063	k__ ; p__Actinomycetota; c__Actinomycetes; o__Micrococcales; f__Microbacteriaceae; g__Microbacterium; s__Microbacterium sp. NIBRBAC000506063
Microbacterium sp. Nx66	k__ ; p__Actinomycetota; c__Actinomycetes; o__Micrococcales; f__Microbacteriaceae; g__Microbacterium; s__Microbacterium sp. Nx66
Kocuria turfanensis	k__ ; p__Actinomycetota; c__Actinomycetes; o__Micrococcales; f__Micrococcaceae; g__Kocuria; s__Kocuria turfanensis
Rothia amarae	k__ ; p__Actinomycetota; c__Actinomycetes; o__Micrococcales; f__Micrococcaceae; g__Rothia; s__Rothia amarae
Mycobacterium sp. MS1601	k__ ; p__Actinomycetota; c__Actinomycetes; o__Mycobacteriales; f__Mycobacteriaceae; g__Mycobacterium; s__Mycobacterium sp. MS1601
Mycobacterium sp. ELW1	k__ ; p__Actinomycetota; c__Actinomycetes; o__Mycobacteriales; f__Mycobacteriaceae; g__Mycobacterium; s__Mycobacterium sp. ELW1
Mycolicibacterium poriferae	k__ ; p__Actinomycetota; c__Actinomycetes; o__Mycobacteriales; f__Mycobacteriaceae; g__Mycolicibacterium; s__Mycolicibacterium poriferae
Mycolicibacterium aubagnense	k__ ; p__Actinomycetota; c__Actinomycetes; o__Mycobacteriales; f__Mycobacteriaceae; g__Mycolicibacterium; s__Mycolicibacterium aubagnense
Mycolicibacterium chubuense	k__ ; p__Actinomycetota; c__Actinomycetes; o__Mycobacteriales; f__Mycobacteriaceae; g__Mycolicibacterium; s__Mycolicibacterium chubuense
Dysgonomonadaceae bacterium zrk40	k__ ; p__Bacteroidota; c__Bacteroidia; o__Bacteroidales; f__Dysgonomonadaceae; g__ ; s__Dysgonomonadaceae bacterium zrk40
Candidatus Entotheonella factor	k__ ; p__Candidatus Tectimicrobiota; c__Candidatus Entotheonellia; o__Candidatus Entotheonellales; f__Candidatus Entotheonellaceae; g__Candidatus Entotheonella; s__Candidatus Entotheonella factor
Sulfitobacter mediterraneus	k__ ; p__Pseudomonadota; c__Alphaproteobacteria; o__Rhodobacterales; f__Roseobacteraceae; g__Sulfitobacter; s__Sulfitobacter mediterraneus
Roseovarius sp. THAF27	k__ ; p__Pseudomonadota; c__Alphaproteobacteria; o__Rhodobacterales; f__Roseobacteraceae; g__Roseovarius; s__Roseovarius sp. THAF27
Dinoroseobacter shibae	k__ ; p__Pseudomonadota; c__Alphaproteobacteria; o__Rhodobacterales; f__Roseobacteraceae; g__Dinoroseobacter; s__Dinoroseobacter shibae
Phaeobacter gallaeciensis	k__ ; p__Pseudomonadota; c__Alphaproteobacteria; o__Rhodobacterales; f__Roseobacteraceae; g__Phaeobacter; s__Phaeobacter gallaeciensis
Celeribacter baekdonensis	k__ ; p__Pseudomonadota; c__Alphaproteobacteria; o__Rhodobacterales; f__Roseobacteraceae; g__Celeribacter; s__Celeribacter baekdonensis
Yoonia vestfoldensis	k__ ; p__Pseudomonadota; c__Alphaproteobacteria; o__Rhodobacterales; f__Paracoccaceae; g__Yoonia; s__Yoonia vestfoldensis
Providencia huaxiensis	k__ ; p__Pseudomonadota; c__Gammaproteobacteria; o__Enterobacterales; f__Morganellaceae; g__Providencia; s__Providencia huaxiensis
Citrobacter telavivensis	k__ ; p__Pseudomonadota; c__Gammaproteobacteria; o__Enterobacterales; f__Enterobacteriaceae; g__Citrobacter; s__Citrobacter telavivensis
Alicycliphilus denitrificans	k__ ; p__Pseudomonadota; c__Betaproteobacteria; o__Burkholderiales; f__Comamonadaceae; g__Alicycliphilus; s__Alicycliphilus denitrificans
Paenarthrobacter aurescens	k__ ; p__Actinomycetota; c__Actinomycetes; o__Micrococcales; f__Micrococcaceae; g__Paenarthrobacter; s__Paenarthrobacter aurescens
Gordonia pseudamarae	k__ ; p__Actinomycetota; c__Actinomycetes; o__Mycobacteriales; f__Gordoniaceae; g__Gordonia; s__Gordonia pseudamarae
Microbacterium sp. YJN-G	k__ ; p__Actinomycetota; c__Actinomycetes; o__Micrococcales; f__Microbacteriaceae; g__Microbacterium; s__Microbacterium sp. YJN-G
Rhizorhabdus wittichii	k__ ; p__Pseudomonadota; c__Alphaproteobacteria; o__Sphingomonadales; f__Sphingomonadaceae; g__Rhizorhabdus; s__Rhizorhabdus wittichii
Thioclava nitratireducens	k__ ; p__Pseudomonadota; c__Alphaproteobacteria; o__Rhodobacterales; f__Paracoccaceae; g__Thioclava; s__Thioclava nitratireducens
Thioclava electrotropha	k__ ; p__Pseudomonadota; c__Alphaproteobacteria; o__Rhodobacterales; f__Paracoccaceae; g__Thioclava; s__Thioclava electrotropha
Falsirhodobacter sp. PG104	k__ ; p__Pseudomonadota; c__Alphaproteobacteria; o__Rhodobacterales; f__Paracoccaceae; g__Falsirhodobacter; s__Falsirhodobacter algicola
Thalassospira marina	k__ ; p__Pseudomonadota; c__Alphaproteobacteria; o__Rhodospirillales; f__Thalassospiraceae; g__Thalassospira; s__Thalassospira marina
Thalassospira xiamenensis	k__ ; p__Pseudomonadota; c__Alphaproteobacteria; o__Rhodospirillales; f__Thalassospiraceae; g__Thalassospira; s__Thalassospira xiamenensis
Vibrio campbellii	k__ ; p__Pseudomonadota; c__Gammaproteobacteria; o__Vibrionales; f__Vibrionaceae; g__Vibrio; s__Vibrio campbellii
Enterobacter cloacae	k__ ; p__Pseudomonadota; c__Gammaproteobacteria; o__Enterobacterales; f__Enterobacteriaceae; g__Enterobacter; s__Enterobacter cloacae
Legionella israelensis	k__ ; p__Pseudomonadota; c__Gammaproteobacteria; o__Legionellales; f__Legionellaceae; g__Legionella; s__Legionella israelensis
Cupriavidus basilensis	k__ ; p__Pseudomonadota; c__Betaproteobacteria; o__Burkholderiales; f__Burkholderiaceae; g__Cupriavidus; s__Cupriavidus basilensis
Cupriavidus sp. EM10	k__ ; p__Pseudomonadota; c__Betaproteobacteria; o__Burkholderiales; f__Burkholderiaceae; g__Cupriavidus; s__Cupriavidus sp. EM10
Cupriavidus metallidurans	k__ ; p__Pseudomonadota; c__Betaproteobacteria; o__Burkholderiales; f__Burkholderiaceae; g__Cupriavidus; s__Cupriavidus metallidurans
Arthrobacter sp. FB24	k__ ; p__Actinomycetota; c__Actinomycetes; o__Micrococcales; f__Micrococcaceae; g__Arthrobacter; s__Arthrobacter sp. FB24
Nocardioides sp. JS614	k__ ; p__Actinomycetota; c__Actinomycetes; o__Propionibacteriales; f__Nocardioidaceae; g__Nocardioides; s__Nocardioides sp. JS614
Sulfitobacter sp. BSw21498	k__ ; p__Pseudomonadota; c__Alphaproteobacteria; o__Rhodobacterales; f__Roseobacteraceae; g__Sulfitobacter; s__Sulfitobacter sp. BSw21498
Leisingera sp. NJS204	k__ ; p__Pseudomonadota; c__Alphaproteobacteria; o__Rhodobacterales; f__Roseobacteraceae; g__Leisingera; s__Leisingera sp. NJS204
Sphingobium sp. MI1205	k__ ; p__Pseudomonadota; c__Alphaproteobacteria; o__Sphingomonadales; f__Sphingomonadaceae; g__Sphingobium; s__Sphingobium sp. MI1205
Acinetobacter sp. 10FS3-1	k__ ; p__Pseudomonadota; c__Gammaproteobacteria; o__Moraxellales; f__Moraxellaceae; g__Acinetobacter; s__Acinetobacter sp. 10FS3-1
Acinetobacter sp. WCHA45	k__ ; p__Pseudomonadota; c__Gammaproteobacteria; o__Moraxellales; f__Moraxellaceae; g__Acinetobacter; s__Acinetobacter sp. WCHA45
Klebsiella sp. WP3-W18-ESBL-02	k__ ; p__Pseudomonadota; c__Gammaproteobacteria; o__Enterobacterales; f__Enterobacteriaceae; g__Klebsiella; s__Klebsiella sp. WP3-W18-ESBL-02
Stenotrophomonas rhizophila	k__ ; p__Pseudomonadota; c__Gammaproteobacteria; o__Lysobacterales; f__Lysobacteraceae; g__Stenotrophomonas; s__Stenotrophomonas rhizophila
Roseivivax sp. THAF197b	k__ ; p__Pseudomonadota; c__Alphaproteobacteria; o__Rhodobacterales; f__Roseobacteraceae; g__Roseivivax; s__Roseivivax sp. THAF197b
Rhizobium rosettiformans	k__ ; p__Pseudomonadota; c__Alphaproteobacteria; o__Hyphomicrobiales; f__Rhizobiaceae; g__Rhizobium; s__Rhizobium rosettiformans
Psychrobacter sp. 4Dc	k__ ; p__Pseudomonadota; c__Gammaproteobacteria; o__Moraxellales; f__Moraxellaceae; g__Psychrobacter; s__Psychrobacter sp. 4Dc
Psychrobacter sp. 4Bb	k__ ; p__Pseudomonadota; c__Gammaproteobacteria; o__Moraxellales; f__Moraxellaceae; g__Psychrobacter; s__Psychrobacter sp. 4Bb
Psychrobacter cryohalolentis	k__ ; p__Pseudomonadota; c__Gammaproteobacteria; o__Moraxellales; f__Moraxellaceae; g__Psychrobacter; s__Psychrobacter cryohalolentis
Acinetobacter radioresistens	k__ ; p__Pseudomonadota; c__Gammaproteobacteria; o__Moraxellales; f__Moraxellaceae; g__Acinetobacter; s__Acinetobacter radioresistens
Escherichia fergusonii	k__ ; p__Pseudomonadota; c__Gammaproteobacteria; o__Enterobacterales; f__Enterobacteriaceae; g__Escherichia; s__Escherichia fergusonii
Diaphorobacter sp. HDW4A	k__ ; p__Pseudomonadota; c__Betaproteobacteria; o__Burkholderiales; f__Comamonadaceae; g__Diaphorobacter; s__Diaphorobacter sp. HDW4A
Acidovorax sp. T1	k__ ; p__Pseudomonadota; c__Betaproteobacteria; o__Burkholderiales; f__Comamonadaceae; g__Acidovorax; s__Acidovorax sp. T1
Mycobacterium dioxanotrophicus	k__ ; p__Actinomycetota; c__Actinomycetes; o__Mycobacteriales; f__Mycobacteriaceae; g__Mycobacterium; s__Mycobacterium dioxanotrophicus
Rhodococcus fascians	k__ ; p__Actinomycetota; c__Actinomycetes; o__Mycobacteriales; f__Nocardiaceae; g__Rhodococcoides; s__Rhodococcoides fascians
Pseudonocardia autotrophica	k__ ; p__Actinomycetota; c__Actinomycetes; o__Pseudonocardiales; f__Pseudonocardiaceae; g__Pseudonocardia; s__Pseudonocardia autotrophica
Marinobacter adhaerens	k__ ; p__Pseudomonadota; c__Gammaproteobacteria; o__Pseudomonadales; f__Marinobacteraceae; g__Marinobacter; s__Marinobacter adhaerens
Roseibium alexandrii	k__ ; p__Pseudomonadota; c__Alphaproteobacteria; o__Hyphomicrobiales; f__Stappiaceae; g__Roseibium; s__Roseibium alexandrii
Variovorax paradoxus	k__ ; p__Pseudomonadota; c__Betaproteobacteria; o__Burkholderiales; f__Comamonadaceae; g__Variovorax; s__Variovorax paradoxus
Haloferax volcanii	k__ ; p__Methanobacteriota; c__Halobacteria; o__Halobacteriales; f__Haloferacaceae; g__Haloferax; s__Haloferax volcanii
Pseudoalteromonas carrageenovora	k__ ; p__Pseudomonadota; c__Gammaproteobacteria; o__Alteromonadales; f__Pseudoalteromonadaceae; g__Pseudoalteromonas; s__Pseudoalteromonas carrageenovora
Pseudoalteromonas nigrifaciens	k__ ; p__Pseudomonadota; c__Gammaproteobacteria; o__Alteromonadales; f__Pseudoalteromonadaceae; g__Pseudoalteromonas; s__Pseudoalteromonas nigrifaciens
Roseomonas gilardii	k__ ; p__Pseudomonadota; c__Alphaproteobacteria; o__Acetobacterales; f__Roseomonadaceae; g__Roseomonas; s__Roseomonas gilardii
Alteromonas stellipolaris	k__ ; p__Pseudomonadota; c__Gammaproteobacteria; o__Alteromonadales; f__Alteromonadaceae; g__Alteromonas; s__Alteromonas stellipolaris
Aquibium oceanicum	k__ ; p__Pseudomonadota; c__Alphaproteobacteria; o__Hyphomicrobiales; f__Phyllobacteriaceae; g__Aquibium; s__Aquibium oceanicum
Caulobacter sp. FWC26	k__ ; p__Pseudomonadota; c__Alphaproteobacteria; o__Caulobacterales; f__Caulobacteraceae; g__Caulobacter; s__Caulobacter sp. FWC26
Hydrogenophaga sp. PBL-H3	k__ ; p__Pseudomonadota; c__Betaproteobacteria; o__Burkholderiales; f__Comamonadaceae; g__Hydrogenophaga; s__Hydrogenophaga sp. PBL-H3
Cupriavidus oxalaticus	k__ ; p__Pseudomonadota; c__Betaproteobacteria; o__Burkholderiales; f__Burkholderiaceae; g__Cupriavidus; s__Cupriavidus oxalaticus
Gordonia sp. KTR9	k__ ; p__Actinomycetota; c__Actinomycetes; o__Mycobacteriales; f__Gordoniaceae; g__Gordonia; s__Gordonia sp. KTR9
Methylophaga frappieri	k__ ; p__Pseudomonadota; c__Gammaproteobacteria; o__Thiotrichales; f__Piscirickettsiaceae; g__Methylophaga; s__Methylophaga frappieri
Sphingobium sp. SCG-1	k__ ; p__Pseudomonadota; c__Alphaproteobacteria; o__Sphingomonadales; f__Sphingomonadaceae; g__Sphingobium; s__Sphingobium sp. SCG-1
Frigidibacter mobilis	k__ ; p__Pseudomonadota; c__Alphaproteobacteria; o__Rhodobacterales; f__Paracoccaceae; g__Frigidibacter; s__Frigidibacter mobilis
Paroceanicella profunda	k__ ; p__Pseudomonadota; c__Alphaproteobacteria; o__Rhodobacterales; f__Paracoccaceae; g__Paroceanicella; s__Paroceanicella profunda
Paraglaciecola mesophila	k__ ; p__Pseudomonadota; c__Gammaproteobacteria; o__Alteromonadales; f__Alteromonadaceae; g__Paraglaciecola; s__Paraglaciecola mesophila
Novosphingobium aromaticivorans	k__ ; p__Pseudomonadota; c__Alphaproteobacteria; o__Sphingomonadales; f__Sphingomonadaceae; g__Novosphingobium; s__Novosphingobium aromaticivorans
Skermanella sp. TT6	k__ ; p__Pseudomonadota; c__Alphaproteobacteria; o__Rhodospirillales; f__Azospirillaceae; g__Skermanella; s__Skermanella cutis
Mycobacterium kansasii	k__ ; p__Actinomycetota; c__Actinomycetes; o__Mycobacteriales; f__Mycobacteriaceae; g__Mycobacterium; s__Mycobacterium kansasii
Mycobacterium frederiksbergense	k__ ; p__Actinomycetota; c__Actinomycetes; o__Mycobacteriales; f__Mycobacteriaceae; g__Mycolicibacterium; s__Mycolicibacterium frederiksbergense
Phaeobacter piscinae	k__ ; p__Pseudomonadota; c__Alphaproteobacteria; o__Rhodobacterales; f__Roseobacteraceae; g__Phaeobacter; s__Phaeobacter piscinae
Roseobacter litoralis	k__ ; p__Pseudomonadota; c__Alphaproteobacteria; o__Rhodobacterales; f__Roseobacteraceae; g__Roseobacter; s__Roseobacter litoralis
Aestuarium zhoushanense	k__ ; p__Pseudomonadota; c__Alphaproteobacteria; o__Rhodobacterales; f__Paracoccaceae; g__Aestuarium; s__Aestuarium zhoushanense
Rhodobacter sp. LPB0142	k__ ; p__Pseudomonadota; c__Alphaproteobacteria; o__Rhodobacterales; f__ ; g__Rhodobacter; s__Rhodobacter xanthinilyticus
Sphingomonas aliaeris	k__ ; p__Pseudomonadota; c__Alphaproteobacteria; o__Sphingomonadales; f__Sphingomonadaceae; g__Sphingomonas; s__Sphingomonas aliaeris
Agrobacterium fabrum	k__ ; p__Pseudomonadota; c__Alphaproteobacteria; o__Hyphomicrobiales; f__Rhizobiaceae; g__Agrobacterium; s__Agrobacterium fabrum
Xanthobacter autotrophicus	k__ ; p__Pseudomonadota; c__Alphaproteobacteria; o__Hyphomicrobiales; f__Xanthobacteraceae; g__Xanthobacter; s__Xanthobacter autotrophicus
Bradyrhizobium betae	k__ ; p__Pseudomonadota; c__Alphaproteobacteria; o__Hyphomicrobiales; f__Nitrobacteraceae; g__Bradyrhizobium; s__Bradyrhizobium betae
Niveispirillum cyanobacteriorum	k__ ; p__Pseudomonadota; c__Alphaproteobacteria; o__Rhodospirillales; f__Azospirillaceae; g__Niveispirillum; s__Niveispirillum cyanobacteriorum
Gayadomonas joobiniege	k__ ; p__Pseudomonadota; c__Gammaproteobacteria; o__Alteromonadales; f__Alteromonadaceae; g__Gayadomonas; s__Gayadomonas joobiniege
Legionella adelaidensis	k__ ; p__Pseudomonadota; c__Gammaproteobacteria; o__Legionellales; f__Legionellaceae; g__Legionella; s__Legionella adelaidensis
Cupriavidus pauculus	k__ ; p__Pseudomonadota; c__Betaproteobacteria; o__Burkholderiales; f__Burkholderiaceae; g__Cupriavidus; s__Cupriavidus pauculus
Brachybacterium avium	k__ ; p__Actinomycetota; c__Actinomycetes; o__Micrococcales; f__Dermabacteraceae; g__Brachybacterium; s__Brachybacterium avium
Staphylococcus saprophyticus	k__ ; p__Bacillota; c__Bacilli; o__Bacillales; f__Staphylococcaceae; g__Staphylococcus; s__Staphylococcus saprophyticus
Paenibacillus sonchi	k__ ; p__Bacillota; c__Bacilli; o__Bacillales; f__Paenibacillaceae; g__Paenibacillus; s__Paenibacillus sonchi
Chryseobacterium sp. ERMR1:04	k__ ; p__Bacteroidota; c__Flavobacteriia; o__Flavobacteriales; f__Weeksellaceae; g__Chryseobacterium; s__Chryseobacterium sp. ERMR1:04
Nonlabens spongiae	k__ ; p__Bacteroidota; c__Flavobacteriia; o__Flavobacteriales; f__Flavobacteriaceae; g__Nonlabens; s__Nonlabens spongiae
Mucilaginibacter sp. PAMC 26640	k__ ; p__Bacteroidota; c__Sphingobacteriia; o__Sphingobacteriales; f__Sphingobacteriaceae; g__Mucilaginibacter; s__Mucilaginibacter sp. PAMC 26640
Borrelia coriaceae	k__ ; p__Spirochaetota; c__Spirochaetia; o__Spirochaetales; f__Borreliaceae; g__Borrelia; s__Borrelia coriaceae
Antarctobacter heliothermus	k__ ; p__Pseudomonadota; c__Alphaproteobacteria; o__Rhodobacterales; f__Roseobacteraceae; g__Antarctobacter; s__Antarctobacter heliothermus
Roseicitreum antarcticum	k__ ; p__Pseudomonadota; c__Alphaproteobacteria; o__Rhodobacterales; f__Paracoccaceae; g__Roseicitreum; s__Roseicitreum antarcticum
Ensifer sp. PDNC004	k__ ; p__Pseudomonadota; c__Alphaproteobacteria; o__Hyphomicrobiales; f__Rhizobiaceae; g__Ensifer; s__Ensifer sp. PDNC004
Methylobacterium currus	k__ ; p__Pseudomonadota; c__Alphaproteobacteria; o__Hyphomicrobiales; f__Methylobacteriaceae; g__Methylobacterium; s__Methylobacterium currus
Xanthobacter dioxanivorans	k__ ; p__Pseudomonadota; c__Alphaproteobacteria; o__Hyphomicrobiales; f__Xanthobacteraceae; g__Xanthobacter; s__Xanthobacter dioxanivorans
Mesorhizobium terrae	k__ ; p__Pseudomonadota; c__Alphaproteobacteria; o__Hyphomicrobiales; f__Phyllobacteriaceae; g__Terribium; s__Terribium terrae
Pseudomonas cerasi	k__ ; p__Pseudomonadota; c__Gammaproteobacteria; o__Pseudomonadales; f__Pseudomonadaceae; g__Pseudomonas; s__Pseudomonas cerasi
Acinetobacter sp. WCHA55	k__ ; p__Pseudomonadota; c__Gammaproteobacteria; o__Moraxellales; f__Moraxellaceae; g__Acinetobacter; s__Acinetobacter sp. WCHA55
Acinetobacter defluvii	k__ ; p__Pseudomonadota; c__Gammaproteobacteria; o__Moraxellales; f__Moraxellaceae; g__Acinetobacter; s__Acinetobacter defluvii
Acinetobacter chinensis	k__ ; p__Pseudomonadota; c__Gammaproteobacteria; o__Moraxellales; f__Moraxellaceae; g__Acinetobacter; s__Acinetobacter chinensis
Leclercia sp. LSNIH1	k__ ; p__Pseudomonadota; c__Gammaproteobacteria; o__Enterobacterales; f__Enterobacteriaceae; g__Leclercia; s__Leclercia sp. LSNIH1
Xanthomonas vesicatoria	k__ ; p__Pseudomonadota; c__Gammaproteobacteria; o__Lysobacterales; f__Lysobacteraceae; g__Xanthomonas; s__Xanthomonas vesicatoria
Cupriavidus taiwanensis	k__ ; p__Pseudomonadota; c__Betaproteobacteria; o__Burkholderiales; f__Burkholderiaceae; g__Cupriavidus; s__Cupriavidus taiwanensis
Mycolicibacterium sp. TY81	k__ ; p__Actinomycetota; c__Actinomycetes; o__Mycobacteriales; f__Mycobacteriaceae; g__Mycolicibacterium; s__Mycolicibacterium sp. TY81
Mycobacterium sp. YC-RL4	k__ ; p__Actinomycetota; c__Actinomycetes; o__Mycobacteriales; f__Mycobacteriaceae; g__Mycobacterium; s__Mycobacterium adipatum
Mycobacterium grossiae	k__ ; p__Actinomycetota; c__Actinomycetes; o__Mycobacteriales; f__Mycobacteriaceae; g__Mycolicibacterium; s__Mycolicibacterium grossiae
Mycobacteroides abscessus	k__ ; p__Actinomycetota; c__Actinomycetes; o__Mycobacteriales; f__Mycobacteriaceae; g__Mycobacteroides; s__Mycobacteroides abscessus
Nocardia farcinica	k__ ; p__Actinomycetota; c__Actinomycetes; o__Mycobacteriales; f__Nocardiaceae; g__Nocardia; s__Nocardia farcinica
Exiguobacterium mexicanum	k__ ; p__Bacillota; c__Bacilli; o__Bacillales; f__ ; g__Exiguobacterium; s__Exiguobacterium mexicanum
Nostoc carneum	k__ ; p__Cyanobacteriota; c__Cyanophyceae; o__Nostocales; f__Nostocaceae; g__Nostoc; s__Nostoc carneum
Tenericutes bacterium MO-XQ	k__ ; p__Mycoplasmatota; c__ ; o__ ; f__ ; g__ ; s__Tenericutes bacterium MO-XQ
Variovorax sp. RA8	k__ ; p__Pseudomonadota; c__Betaproteobacteria; o__Burkholderiales; f__Comamonadaceae; g__Variovorax; s__Variovorax sp. RA8
Caulobacter sp. K31	k__ ; p__Pseudomonadota; c__Alphaproteobacteria; o__Caulobacterales; f__Caulobacteraceae; g__Caulobacter; s__Caulobacter sp. K31
Phenylobacterium zucineum	k__ ; p__Pseudomonadota; c__Alphaproteobacteria; o__Caulobacterales; f__Caulobacteraceae; g__Phenylobacterium; s__Phenylobacterium zucineum
Pseudomonas sp. SDM007	k__ ; p__Pseudomonadota; c__Gammaproteobacteria; o__Pseudomonadales; f__Pseudomonadaceae; g__Pseudomonas; s__Pseudomonas hygromyciniae
Photobacterium sp. GJ3	k__ ; p__Pseudomonadota; c__Gammaproteobacteria; o__Vibrionales; f__Vibrionaceae; g__Photobacterium; s__Photobacterium sp. GJ3
Morganella morganii	k__ ; p__Pseudomonadota; c__Gammaproteobacteria; o__Enterobacterales; f__Morganellaceae; g__Morganella; s__Morganella morganii
Enterobacter sp. R4-368	k__ ; p__Pseudomonadota; c__Gammaproteobacteria; o__Enterobacterales; f__Enterobacteriaceae; g__Enterobacter; s__Enterobacter sp. R4-368
Caballeronia insecticola	k__ ; p__Pseudomonadota; c__Betaproteobacteria; o__Burkholderiales; f__Burkholderiaceae; g__Caballeronia; s__Caballeronia insecticola
Ralstonia pickettii	k__ ; p__Pseudomonadota; c__Betaproteobacteria; o__Burkholderiales; f__Burkholderiaceae; g__Ralstonia; s__Ralstonia pickettii
Mitsuaria sp. 7	k__ ; p__Pseudomonadota; c__Betaproteobacteria; o__Burkholderiales; f__Sphaerotilaceae; g__Roseateles; s__Mitsuaria sp. 7
Planococcus sp. MB-3u-03	k__ ; p__Bacillota; c__Bacilli; o__Bacillales; f__Caryophanaceae; g__Planococcus; s__Planococcus sp. MB-3u-03
Nostoc sp. C052	k__ ; p__Cyanobacteriota; c__Cyanophyceae; o__Nostocales; f__Nostocaceae; g__Nostoc; s__Nostoc sp. C052
Acinetobacter sp. WCHAc010034	k__ ; p__Pseudomonadota; c__Gammaproteobacteria; o__Moraxellales; f__Moraxellaceae; g__Acinetobacter; s__Acinetobacter sp. WCHAc010034
Pseudoalteromonas xiamenensis	k__ ; p__Pseudomonadota; c__Gammaproteobacteria; o__Alteromonadales; f__Pseudoalteromonadaceae; g__Pseudoalteromonas; s__Pseudoalteromonas xiamenensis
Vibrio azureus	k__ ; p__Pseudomonadota; c__Gammaproteobacteria; o__Vibrionales; f__Vibrionaceae; g__Vibrio; s__Vibrio azureus
Marinomonas algicola	k__ ; p__Pseudomonadota; c__Gammaproteobacteria; o__Oceanospirillales; f__Oceanospirillaceae; g__Marinomonas; s__Marinomonas algicola
Novosphingobium sp. THN1	k__ ; p__Pseudomonadota; c__Alphaproteobacteria; o__Sphingomonadales; f__Sphingomonadaceae; g__Novosphingobium; s__Novosphingobium sp. THN1
Sphingomonas changnyeongensis	k__ ; p__Pseudomonadota; c__Alphaproteobacteria; o__Sphingomonadales; f__Sphingomonadaceae; g__Sphingomonas; s__Sphingomonas changnyeongensis
Sphingomonas taxi	k__ ; p__Pseudomonadota; c__Alphaproteobacteria; o__Sphingomonadales; f__Sphingomonadaceae; g__Sphingomonas; s__Sphingomonas taxi
Sphingomonas insulae	k__ ; p__Pseudomonadota; c__Alphaproteobacteria; o__Sphingomonadales; f__Sphingomonadaceae; g__Sphingomonas; s__Sphingomonas insulae
Rhizobium pseudoryzae	k__ ; p__Pseudomonadota; c__Alphaproteobacteria; o__Hyphomicrobiales; f__Rhizobiaceae; g__Allorhizobium; s__Allorhizobium pseudoryzae
Hoeflea sp. IMCC20628	k__ ; p__Pseudomonadota; c__Alphaproteobacteria; o__Hyphomicrobiales; f__Rhizobiaceae; g__Hoeflea; s__Hoeflea sp. IMCC20628
Hartmannibacter diazotrophicus	k__ ; p__Pseudomonadota; c__Alphaproteobacteria; o__Hyphomicrobiales; f__Pleomorphomonadaceae; g__Hartmannibacter; s__Hartmannibacter diazotrophicus
Ketogulonicigenium vulgare	k__ ; p__Pseudomonadota; c__Alphaproteobacteria; o__Rhodobacterales; f__Roseobacteraceae; g__Ketogulonicigenium; s__Ketogulonicigenium vulgare
Paracoccus liaowanqingii	k__ ; p__Pseudomonadota; c__Alphaproteobacteria; o__Rhodobacterales; f__Paracoccaceae; g__Paracoccus; s__Paracoccus liaowanqingii
Paracoccus aminophilus	k__ ; p__Pseudomonadota; c__Alphaproteobacteria; o__Rhodobacterales; f__Paracoccaceae; g__Paracoccus; s__Paracoccus aminophilus
Gemmobacter aquarius	k__ ; p__Pseudomonadota; c__Alphaproteobacteria; o__Rhodobacterales; f__Paracoccaceae; g__Paragemmobacter; s__Paragemmobacter aquarius
Acinetobacter sp. NCu2D-2	k__ ; p__Pseudomonadota; c__Gammaproteobacteria; o__Moraxellales; f__Moraxellaceae; g__Acinetobacter; s__Acinetobacter sp. NCu2D-2
Acinetobacter sp. CS-2	k__ ; p__Pseudomonadota; c__Gammaproteobacteria; o__Moraxellales; f__Moraxellaceae; g__Acinetobacter; s__Acinetobacter sp. CS-2
Acinetobacter baumannii	k__ ; p__Pseudomonadota; c__Gammaproteobacteria; o__Moraxellales; f__Moraxellaceae; g__Acinetobacter; s__Acinetobacter baumannii
Microbacterium chocolatum	k__ ; p__Actinomycetota; c__Actinomycetes; o__Micrococcales; f__Microbacteriaceae; g__Microbacterium; s__Microbacterium aurantiacum
Mycobacterium kubicae	k__ ; p__Actinomycetota; c__Actinomycetes; o__Mycobacteriales; f__Mycobacteriaceae; g__Mycobacterium; s__Mycobacterium kubicae
Dietzia lutea	k__ ; p__Actinomycetota; c__Actinomycetes; o__Mycobacteriales; f__Dietziaceae; g__Dietzia; s__Dietzia lutea
Staphylococcus pragensis	k__ ; p__Bacillota; c__Bacilli; o__Bacillales; f__Staphylococcaceae; g__Staphylococcus; s__Staphylococcus pragensis
Staphylococcus argenteus	k__ ; p__Bacillota; c__Bacilli; o__Bacillales; f__Staphylococcaceae; g__Staphylococcus; s__Staphylococcus argenteus
Staphylococcus haemolyticus	k__ ; p__Bacillota; c__Bacilli; o__Bacillales; f__Staphylococcaceae; g__Staphylococcus; s__Staphylococcus haemolyticus
Staphylococcus pseudoxylosus	k__ ; p__Bacillota; c__Bacilli; o__Bacillales; f__Staphylococcaceae; g__Staphylococcus; s__Staphylococcus pseudoxylosus
Halorubrum sp. CBA1229	k__ ; p__Methanobacteriota; c__Halobacteria; o__Halobacteriales; f__Haloferacaceae; g__Halorubrum; s__Halorubrum sp. CBA1229
Halorubrum trapanicum	k__ ; p__Methanobacteriota; c__Halobacteria; o__Halobacteriales; f__Haloferacaceae; g__Halorubrum; s__Halorubrum trapanicum
Halolamina sp. CBA1230	k__ ; p__Methanobacteriota; c__Halobacteria; o__Halobacteriales; f__Haloferacaceae; g__Halolamina; s__Halolamina sp. CBA1230
Halobacterium hubeiense	k__ ; p__Methanobacteriota; c__Halobacteria; o__Halobacteriales; f__Halobacteriaceae; g__Halobacterium; s__Halobacterium hubeiense
Natrinema versiforme	k__ ; p__Methanobacteriota; c__Halobacteria; o__Halobacteriales; f__Natrialbaceae; g__Natrinema; s__Natrinema versiforme
Psychrobacter sp. P11F6	k__ ; p__Pseudomonadota; c__Gammaproteobacteria; o__Moraxellales; f__Moraxellaceae; g__Psychrobacter; s__Psychrobacter sp. P11F6
Psychrobacter sp. P11G3	k__ ; p__Pseudomonadota; c__Gammaproteobacteria; o__Moraxellales; f__Moraxellaceae; g__Psychrobacter; s__Psychrobacter sp. P11G3
Psychrobacter sp. P2G3	k__ ; p__Pseudomonadota; c__Gammaproteobacteria; o__Moraxellales; f__Moraxellaceae; g__Psychrobacter; s__Psychrobacter sp. P2G3
Psychrobacter sp. WY6	k__ ; p__Pseudomonadota; c__Gammaproteobacteria; o__Moraxellales; f__Moraxellaceae; g__Psychrobacter; s__Psychrobacter sp. WY6
Psychrobacter alimentarius	k__ ; p__Pseudomonadota; c__Gammaproteobacteria; o__Moraxellales; f__Moraxellaceae; g__Psychrobacter; s__Psychrobacter alimentarius
Psychrobacter urativorans	k__ ; p__Pseudomonadota; c__Gammaproteobacteria; o__Moraxellales; f__Moraxellaceae; g__Psychrobacter; s__Psychrobacter urativorans
Octadecabacter arcticus	k__ ; p__Pseudomonadota; c__Alphaproteobacteria; o__Rhodobacterales; f__Roseobacteraceae; g__Octadecabacter; s__Octadecabacter arcticus
Ensifer adhaerens	k__ ; p__Pseudomonadota; c__Alphaproteobacteria; o__Hyphomicrobiales; f__Rhizobiaceae; g__Ensifer; s__Ensifer adhaerens
Kocuria flava	k__ ; p__Actinomycetota; c__Actinomycetes; o__Micrococcales; f__Micrococcaceae; g__Kocuria; s__Kocuria flava
Natrinema pellirubrum	k__ ; p__Methanobacteriota; c__Halobacteria; o__Halobacteriales; f__Natrialbaceae; g__Natrinema; s__Natrinema pellirubrum
Tabrizicola piscis	k__ ; p__Pseudomonadota; c__Alphaproteobacteria; o__Rhodobacterales; f__Paracoccaceae; g__Tabrizicola; s__Tabrizicola piscis
Neorhizobium sp. NCHU2750	k__ ; p__Pseudomonadota; c__Alphaproteobacteria; o__Hyphomicrobiales; f__Rhizobiaceae; g__Neorhizobium; s__Neorhizobium sp. NCHU2750
Fluoribacter dumoffii	k__ ; p__Pseudomonadota; c__Gammaproteobacteria; o__Legionellales; f__Legionellaceae; g__Fluoribacter; s__Fluoribacter dumoffii
Sulfuriferula sp. AH1	k__ ; p__Pseudomonadota; c__Betaproteobacteria; o__Nitrosomonadales; f__Sulfuricellaceae; g__Sulfuriferula; s__Sulfuriferula sp. AH1
Nostoc linckia	k__ ; p__Cyanobacteriota; c__Cyanophyceae; o__Nostocales; f__Nostocaceae; g__Nostoc; s__Nostoc linckia
Acinetobacter sp. LoGeW2-3	k__ ; p__Pseudomonadota; c__Gammaproteobacteria; o__Moraxellales; f__Moraxellaceae; g__Acinetobacter; s__Acinetobacter sp. LoGeW2-3
Acinetobacter wuhouensis	k__ ; p__Pseudomonadota; c__Gammaproteobacteria; o__Moraxellales; f__Moraxellaceae; g__Acinetobacter; s__Acinetobacter wuhouensis
Kosakonia radicincitans	k__ ; p__Pseudomonadota; c__Gammaproteobacteria; o__Enterobacterales; f__Enterobacteriaceae; g__Kosakonia; s__Kosakonia radicincitans
Leclercia adecarboxylata	k__ ; p__Pseudomonadota; c__Gammaproteobacteria; o__Enterobacterales; f__Enterobacteriaceae; g__Leclercia; s__Leclercia adecarboxylata
Psychrobacter sp. Choline-02u-9	k__ ; p__Pseudomonadota; c__Gammaproteobacteria; o__Moraxellales; f__Moraxellaceae; g__Psychrobacter; s__Psychrobacter sp. Choline-02u-9
Legionella sp. PC1000	k__ ; p__Pseudomonadota; c__Gammaproteobacteria; o__Legionellales; f__Legionellaceae; g__Legionella; s__Legionella sp. PC1000
Arthrobacter sp. ERGS1:01	k__ ; p__Actinomycetota; c__Actinomycetes; o__Micrococcales; f__Micrococcaceae; g__Arthrobacter; s__Arthrobacter sp. ERGS1:01
Pseudonocardia sp. EC080619-01	k__ ; p__Actinomycetota; c__Actinomycetes; o__Pseudonocardiales; f__Pseudonocardiaceae; g__Pseudonocardia; s__Pseudonocardia sp. EC080619-01
Planococcus donghaensis	k__ ; p__Bacillota; c__Bacilli; o__Bacillales; f__Caryophanaceae; g__Planococcus; s__Planococcus donghaensis
Gemmatirosa kalamazoonensis	k__ ; p__Gemmatimonadota; c__Gemmatimonadia; o__Gemmatimonadales; f__Gemmatimonadaceae; g__Gemmatirosa; s__Gemmatirosa kalamazoonensis
Prevotella sp. oral taxon 299	k__ ; p__Bacteroidota; c__Bacteroidia; o__Bacteroidales; f__Prevotellaceae; g__Prevotella; s__Prevotella sp. oral taxon 299
Cereibacter sphaeroides	k__ ; p__Pseudomonadota; c__Alphaproteobacteria; o__Rhodobacterales; f__Paracoccaceae; g__Cereibacter; s__Cereibacter sphaeroides
Methylobacterium aquaticum	k__ ; p__Pseudomonadota; c__Alphaproteobacteria; o__Hyphomicrobiales; f__Methylobacteriaceae; g__Methylobacterium; s__Methylobacterium aquaticum
Methylobacterium sp. DM1	k__ ; p__Pseudomonadota; c__Alphaproteobacteria; o__Hyphomicrobiales; f__Methylobacteriaceae; g__Methylobacterium; s__Methylobacterium sp. DM1
Klebsiella michiganensis	k__ ; p__Pseudomonadota; c__Gammaproteobacteria; o__Enterobacterales; f__Enterobacteriaceae; g__Klebsiella; s__Klebsiella michiganensis
Enterobacter cloacae complex sp.	k__ ; p__Pseudomonadota; c__Gammaproteobacteria; o__Enterobacterales; f__Enterobacteriaceae; g__Enterobacter; s__Enterobacter cloacae complex sp.
Enterobacter sp. RHBSTW-00175	k__ ; p__Pseudomonadota; c__Gammaproteobacteria; o__Enterobacterales; f__Enterobacteriaceae; g__Enterobacter; s__Enterobacter sp. RHBSTW-00175
Burkholderia ambifaria	k__ ; p__Pseudomonadota; c__Betaproteobacteria; o__Burkholderiales; f__Burkholderiaceae; g__Burkholderia; s__Burkholderia ambifaria
Staphylococcus aureus	k__ ; p__Bacillota; c__Bacilli; o__Bacillales; f__Staphylococcaceae; g__Staphylococcus; s__Staphylococcus aureus
Vibrio europaeus	k__ ; p__Pseudomonadota; c__Gammaproteobacteria; o__Vibrionales; f__Vibrionaceae; g__Vibrio; s__Vibrio europaeus
Hydrocarboniclastica marina	k__ ; p__Pseudomonadota; c__Gammaproteobacteria; o__Alteromonadales; f__Alteromonadaceae; g__Hydrocarboniclastica; s__Hydrocarboniclastica marina
Providencia vermicola	k__ ; p__Pseudomonadota; c__Gammaproteobacteria; o__Enterobacterales; f__Morganellaceae; g__Providencia; s__Providencia vermicola
Paraburkholderia sprentiae	k__ ; p__Pseudomonadota; c__Betaproteobacteria; o__Burkholderiales; f__Burkholderiaceae; g__Paraburkholderia; s__Paraburkholderia sprentiae
Neorhizobium sp. SOG26	k__ ; p__Pseudomonadota; c__Alphaproteobacteria; o__Hyphomicrobiales; f__Rhizobiaceae; g__Neorhizobium; s__Neorhizobium sp. SOG26
Cupriavidus necator	k__ ; p__Pseudomonadota; c__Betaproteobacteria; o__Burkholderiales; f__Burkholderiaceae; g__Cupriavidus; s__Cupriavidus necator
Leuconostoc lactis	k__ ; p__Bacillota; c__Bacilli; o__Lactobacillales; f__Lactobacillaceae; g__Leuconostoc; s__Leuconostoc lactis
Serratia liquefaciens	k__ ; p__Pseudomonadota; c__Gammaproteobacteria; o__Enterobacterales; f__Yersiniaceae; g__Serratia; s__Serratia liquefaciens
Azospirillum humicireducens	k__ ; p__Pseudomonadota; c__Alphaproteobacteria; o__Rhodospirillales; f__Azospirillaceae; g__Azospirillum; s__Azospirillum humicireducens
Thauera aromatica	k__ ; p__Pseudomonadota; c__Betaproteobacteria; o__Rhodocyclales; f__Zoogloeaceae; g__Thauera; s__Thauera aromatica
Lachnospira eligens	k__ ; p__Bacillota; c__Clostridia; o__Lachnospirales; f__Lachnospiraceae; g__Lachnospira; s__Lachnospira eligens
Prevotella copri	k__ ; p__Bacteroidota; c__Bacteroidia; o__Bacteroidales; f__Prevotellaceae; g__Segatella; s__Segatella copri
Sphingobium sp. KCTC 72723	k__ ; p__Pseudomonadota; c__Alphaproteobacteria; o__Sphingomonadales; f__Sphingomonadaceae; g__Sphingobium; s__Sphingobium sp. KCTC 72723
Blastomonas fulva	k__ ; p__Pseudomonadota; c__Alphaproteobacteria; o__Sphingomonadales; f__Sphingomonadaceae; g__Blastomonas; s__Blastomonas fulva
Bosea sp. F3-2	k__ ; p__Pseudomonadota; c__Alphaproteobacteria; o__Hyphomicrobiales; f__Boseaceae; g__Bosea; s__Bosea sp. F3-2
Bosea sp. AS-1	k__ ; p__Pseudomonadota; c__Alphaproteobacteria; o__Hyphomicrobiales; f__Boseaceae; g__Bosea; s__Bosea sp. AS-1
Variovorax sp. WS11	k__ ; p__Pseudomonadota; c__Betaproteobacteria; o__Burkholderiales; f__Comamonadaceae; g__Variovorax; s__Variovorax sp. WS11
Acidovorax antarcticus	k__ ; p__Pseudomonadota; c__Betaproteobacteria; o__Burkholderiales; f__Comamonadaceae; g__Comamonas; s__Comamonas antarctica
Ralstonia syzygii	k__ ; p__Pseudomonadota; c__Betaproteobacteria; o__Burkholderiales; f__Burkholderiaceae; g__Ralstonia; s__Ralstonia syzygii
Sphaerotilus sulfidivorans	k__ ; p__Pseudomonadota; c__Betaproteobacteria; o__Burkholderiales; f__Sphaerotilaceae; g__Sphaerotilus; s__Sphaerotilus sulfidivorans
Thauera sp. K11	k__ ; p__Pseudomonadota; c__Betaproteobacteria; o__Rhodocyclales; f__Zoogloeaceae; g__Thauera; s__Thauera sp. K11
Salinigranum rubrum	k__ ; p__Methanobacteriota; c__Halobacteria; o__Halobacteriales; f__Haloferacaceae; g__Salinigranum; s__Salinigranum rubrum
